WWWWWWWWWWWWWWWWWWWWWWWWWWWWWWWWWWWWWWWW
WOOOOOOOOOOOOOOOOOOWWOOOOOOOOOOOOOOOOOOW
WOOOOOOOOOOOOOOOOOOWWOOOOOOOOOOOOOOOOOOW
WOOOOOOOOOOOOOOOOOOWWOOOOOOOOOOOOOOOOOOW
WOOOOOOOOOOOOOOOOOOWWOOOOOOOOOOOOOOOOOOW
WOOOOOOOOOOOOOOOOOOWWOOOOOOOOOOOOOOOOOOW
WOOOOOOOOOOOOOOOOOOOOOOOOOOOOOOOOOOOOOOW
WOOOOOOOOOOOOOOOOOOOOOOOOOOOOOOOOOOOOOOW
WOOOOOOOOOOOOOOOOOOOOOOOOOOOOOOOOOOOOOOW
WOOOOOOOOOOOOOOOOOOOOOOOOOOOOOOOOOOOOOOW
WOOOOOOOOOOOOOOOOOOWWOOOOOOOOOOOOOOOOOOW
WOOOOOOOOOOOOOOOOOOWWOOOOOOOOOOOOOOOOOOW
WOOOOOOOOOOOOOOOOOOWWOOOOOOOOOOOOOOOOOOW
WOOOOOOOOOOOOOOOOOOWWOOOOOOOOOOOOOOOOOOW
WOOOOOOOOOOOOOOOOOOWWOOOOOOOOOOOOOOOOOOW
WOOOOOOOOOOOOOOOOOOWWOOOOOOOOOOOOOOOOOOW
WOOOOOOOOOOOOOOOOOOWWOOOOOOOOOOOOOOOOOOW
WOOOOOOOOOOOOOOOOOOWWOOOOOOOOOOOOOOOOOOW
WOOOOOOOOOOOOOOOOOOWWOOOOOOOOOOOOOOOOOOW
WWWWWWWWWWWWWWWWWWWWWWWWWWWWWWWWWWWWWWWW