WWWWWWWWWWWWWWWWWWWWWWWWWWWWWWWWWWWWWWWW
WOOOOOOOOOOOOOOOOOOWWOOOOOOOOOOOOOOOOOOW
WOOOOOOOOOOOOOOOOOOWWOOOOOOOOOOOOOOOOOOW
WOOOOOOOOOWOOOOOOOOWWOOOOOOOOOOOOOOOOOOW
WOOOOOOOOOOOOOOOOOOWWOOOOOOOOOOOOOOOOOOW
WWWWWWWWWOOOOOOOOOOWWOOOOOOOOOOOOOOOOOOW
WOOOOOOOOOOOOOOOOOOOOOOOOOOOOOOOOOOOOOOW
WOOOOOOOOOOOOOOOOOOOOOOOOOOOOOOOOOOOOOOW
WOOOOOOOOOOOOOOOOOOOOOOOOOOOOOOOOOOOOOOW
WOOOOOOOOOOOOOOOOOOOOOOOOOOOOOOOOOOOOOOW
WOOOOOOOOOOOOOOOOOOWWOOOOOOOOOOOOOOOOOOW
WOOOOOOOOOOOOOOOOOOWWOOOOOOOOOOOOOOOOOOW
WOOOOOOOOOOOOOOOOOOWWOOOOOOOOOOOOOOOOOOW
WOOOOOOOOOOOOOOOOOOWWOOOOOOOOOOOOOOOOOOW
WOOOOOOOOOOOOOOOOOOWWOOOOOOOOOOOOOOOOOOW
WOOOOOOOOOOOOOOOOOOWWOOOOOOOOOOOOOOOOOOW
WOOOOOOOOOOOOOOOOOOWWOOOOOOOOOOOOOOOOOOW
WOOOOOOOOOOOOOOOOOOWWOOOOOOOOOOOOOOOOOOW
WOOOOOOOOOOOOOOOOOOWWOOOOOOOOOOOOOOOOOOW
WWWWWWWWWWWWWWWWWWWWWWWWWWWWWWWWWWWWWWWW